###################################################################################################
#                 #             #                       #   #     #       #     #         #     # #
################# ##### ####### ########### # ######### # # # ### # # ##### # ### ##### # # # # # #
#           #   #       # #     #     #   # #   # #     # #   # #   #   #   #     #   # #   # # # #
# ##### ### ### ######### # ##### ### # # ### # # # ##### ##### ####### # ######### # ### ### # # #
# #   # #   #             # #     # #   #   # # # # #             #   # # #   #   # #   # #   #   #
# ### # ### # ########### # ##### # ####### # # #!# # ############# # # # # # ### # ### ### ##### #
#     #   # #     #   # # # #   # #   #   # # # # # #   #           #   # # #     # #     # #   # #
##### ### # ### # # # # # # # # # # # # # # ### # # ##### ############# # # ####### ##### # # # # #
#   #   # #   # #   # #   # # #   # #   # #     #   #   # #   #     #   # #       #   # #   # #   #
# # # ### ### ##### # ### # # ######### # ####### ### # # # # ### ### ### # ##### ### # ##### #####
# # # #   #       # #   # # #         # #   #     #   # #   #   #     #   #   #     # #   #       #
# ### # ######### # ### # # ######### # ### # ####### # ##### # ####### ##### # ### # ### # ##### #
#     # #   #   # #   # # #           # # #   #       #     # # #       #     #   # #   #   #   # #
# ##### # # # # # ##### # ############# # ######### ####### ### # ###############o# ### ### # # ###
# #     # #   # #       # #   #     #   #           #       #   #   #             #   #   # # #   #
# # ##### ##### ######### # # # ### # ##### ######### ####### # ### # ####### ########### ### ### #
# #       #   #   #         # #   # # #   #   #     # #       # #     #       #         #       # #
# ######### ##### ########### ##### # # # # # # # ### # ### # ### ####### ##### ####### ####### # #
#     #         #       #   #   #   # # # # # # #o  # # # # # #     #   #   #   #   #   #     # # #
##### ### ##### ####### ### ### # # # # # # # # ### # # # # ### ##### # ### # ### # # ### ### ### #
#   #   # #   #     # #   #       # #   # # # #   #   # # #     # #   # #   # # # # # #     #     #
# ##### # # # ### # # ### ######### ##### # # ### ##### # ####### # ### ##### # # # # # ### ##### #
#   #   # # #   # #     #       #     #   #A# # # #   # #   #   # # # #       #   # # #   #   #   #
# # # ### # ##### ##### ####### ####### ##### # # # # # # # # # # # # ######### ### # ####### #####
# # #   #   #     #   # #     #         #     #   # #     #   #   # # #       #   #   #     #     #
### ### ##### ##### ### ##### ###########o##### ################### # # # ### ### ##### ### # ### #
#     #   #   #       #   #       #   #   # #   #               #   # # # # #   #       # # #   # #
# ####### # ######### ### # ##### ### # # # # ### ############# # ### # # # ### ######### # ##### #
#   #   #   #         # # #     #   # # # #       #   #       #   # #   # # #   #   #     #   #   #
# # # # ##### ####### # # ##### ### # # # ######### ### ### ####### # ### # # ### ### ### ### # # #
# #   #   #   #         # #     #   #   #       #       # #     # #     # # # #     # # #   #   # #
# ##### ### # ########### # ##### ######### ### # ####### ### # # # ##### # # # ### # # # ####### #
#   #   #   # #   #   #   # #             # # # #         #   #   # #     #   #   # #   # #     # #
### # ### ### # # # # # ### ############# # # # ##### ##### ##### # # ##### ####### ### # # ### # #
# # #     # #   # # # #   #       # #   # #   # # #   #     #     # # #               # #   #   # #
# # ####### ##### # # ### ####### # # # # ##### # # ### ########### # ################# ##### ### #
#               #   #             #   #         #     #             #                       #     #
###################################################################################################

