###################################################################################################
#   # #         #       #       #     #               # #       #                           #     #
### # # # # ##### ##### # ### ### # # # # ########### # # # ##### ############### ########### ### #
# # # # # # #   #   # # #   #     # # # #     #   #   # # #           #         #     #   #   # # #
# # # # # ### # ### # # # ##### ### # ####### ### # ### # ############# ####### # ### # # # ### # #
#   #   #     #   #   #   #   # #   #   #   #   #   # #   #       #     #   #   # # #   #       # #
# ### ########### ### ##### # # # ##### # # ### # ### # ### ##### # ##### ### ### # ########### # #
# # # #     #   #     #   # # # #     #   #   # # #   # # #     #   #   # #   #   #     #   #   # #
# # # # ##### # # ##### # # # ####### ####### # # # ### # ##### ##### # # # ##### # ##### # ##### #
# # #   #     # # #   # #   #       # # #     # # #   # #   # # # #   #   #     #   #     #     # #
# # # ### ##### # ### # ########### # # # ##### # # # # # # # # # # # ######### ### # ######### # #
# #   #   #     #     #   #       #   #   #     # # # # # #   # #   #           #   #         #   #
# ##### ### ############# ##### ####### ####### # ### # # ##### # ############### ########### ### #
#     #   #       #     # #     #     #         #   #     #     # # #           # #       #   #   #
##### ### ####### # ### # # ##### # ############### # ##### ##### # # ##### ##### ##### ### ### ###
#   #   #     # #   #   # #       #               # # #     #   # #       #     #     # #   #     #
# # ### ##### # ##### ### # ########### ########### # # ##### ### #######A##### ##### # # ####### #
# #   #       #       #   # #   #     #             # # #   #   #   #   # #   #     #   # #   #   #
# ### ######### ####### ### # # # ### ################# # # # # ### # ### ### ### # # ### # # #####
# # #   #       #     # # # # # # #       #         #   # # # #     #   #   #   # # # #   # #     #
# # ### # ####### ### # # # # ### # ##### # ### ### # ### ### ######### ### # # # ### # ### ##### #
# #     #   #     #   # #   #     #   # # #   #   #   #     #     #   #     # # #   # #   # #     #
# ######### ##### # ### ### # ####### # # ##### # ######### ##### # # ### ### ##### # ### # # #####
#         #     # #   #   # # #   #   # #     # # #           # #   #   #   #     #   # #   #     #
# ##### ####### # ### ### # # # # # ### ##### ### # ### ##### # ####### ### ##### ##### ######### #
#     #       # # # # #   # #   # #   #     #     #   #     #     #   # #     #   #             # #
##### ####### # # # # # ### ##### ### # # ########### ##### ### ### # # ##### # # # ### ######### #
# #     #     #   #   #   #     # #   # #     #   #   # #   #   #   #   #   #   #   #   #   #     #
# # ##### ### ##### ##### ##### ### ### ##### # # # ### # ####### ####### # ### ####### # # # ### #
# # #     # # #   #       #     #   # #     #   # #     # #   #   #     # # #   #     # # #   #   #
# # # ##### # # # ######### ##### ### # ######### ##### # # # # ### ### # # # ### ### ### ##### ###
# # #   #   # # # #         #     #     #           #   # # # #     #   # # # #   # #   #   # #   #
# # ### # ### # # # ########### ######### ### ####### ### # # ####### ### # ### ### ### ### # ### #
# #   # #   #   # #   #         #         #   #       # # # # #     #   # #   #   #   #     #   # #
# ### # ### # ####### ##### # ##### ### ####### ####### # # # # # ##### # ### # # ### ####### # # #
#   # #   #   #     #     # #     # #   #     # #   #   # # #   #     # # # # # #   # #       # # #
# # # ### ##### ### ##### ####### # ##### ### # # # # # # # ######### # # # # ##### # # ####### # #
# #     #         #               #         #     #   # #           #     #         #         #  o#
###################################################################################################

