###################################################################################################
# #         #     #           #           o #   #     #     #         #       #       #   # #     #
# ##### ### # ### ##### ##### # # ######### # ### # ### # ### # ####### # ### # ##### # # # # ### #
# #     # #   # #     #     #   # #       # #     # #   # #   #   #     # # # #   # # # #   #   # #
# # ##### ##### ##### ##### ##### # ####### ####### # ### # ##### # ##### # # ### # # # ####### # #
#   #             # #   #   #   # #   #   #   #     #   #   #   #   #   # # #     # # # #       # #
##### ####### ### # ### # ### # # ### # # ### # ####### ##### ##### # ### # ####### # # # ####### #
#     #       # # #   # #     # #   # # #   # #       #   #   #   #   #   # #       # # # #       #
# ##### ####### # ### # ##### ##### # # ### # # ### ##### # # # # ##### ### # ##### # # # # ##### #
# #     #       # #   # # #   #   # # #   # # #   #         # # # #     #   #     # # # # # #   # #
# # ##### ### ### # ### # # ### # # # ### # # ####### ######### # # ##### # ##### # # # # # ### # #
# #   # # # # #   # #   #   #   #   #   # # #       # #     #   #   #     #   #   #   #   #   #   #
# ### # # # # # ### # ####### ####### # # # ####### ### ### # ####### # ####### ############# #####
#   # # #   #   #   #   #     #       #   #         #   #   #   # #   #     #   #           #     #
##### # ### ##### # ### # ######### ####### ######### ### ##### # # ####### # ### ##### ### ##### #
#   # #         # # #   #         # #     #   #       #   #     #     #   # # #     #   #         #
# # # ######### ### # ##### ##### ### ### ### # ####### ##### ######### # # # ####### # ######### #
# # #     #   #     #     # #   #   # # #   #   # #   #     #           # # #     #   # #   #   # #
# # ##### # # # ######### ### # # # # # ### ##### # # ##### ### ######### # ##### # ##### # # # # #
# #   #   # # # #   #   #     # # #   #   # #     # #     #   # #         # #     # #     # # #   #
# ### # ### # ### # # # ####### # ####### # ##### # ### ##### ### ######### # ##### # ##### # #####
#   #   #   #   # #   #     #   #         #     #   # #     # #   #     #   #     #   # #   #     #
# # ##### ##### # ####### # # ################# # ### ##### # # ##### # # ####### # ### # ####### #
# #     #   # #   # o   # # # #             #   #     #   # #   #     # #   #     #     #       # #
# ##### ### # ##### ##### # # # # ######### # ####### # ### ####### ### ### # ######### ####### ###
# #   #   # #       #     # # # # #     #   #   #     #   #         #       #   #       #     #   #
# ### ### # # ##### # ##### # # ### ### ### ### # ####### # ####### ########### ######### ### ### #
#     # #   #     # #   #   # #       #   #     #   #   # # # #     #         #           # #     #
##### # ######### # ### ### # # ####### # ######### # # # # # # ##### ####### ############# ##### #
#     #   #   #   #   #   # # # # #   # # #     #  o  #   # # #   #   #     #     #   # #   #     #
# ##### # # # # ######### ### # # # # ### # ### # ####### # # ### # ##### # ### # # # # # # # #####
#       #   # #     #   #   # # # # # #   # # #A#   #   # # #     #   #   #   # #   #   # #   #   #
############# ##### # # ### # # # # # # ### # # ##### # ### # ####### # ####### ##### ### ##### # #
#   #       #     # # #     # #   # # #       #     # #     # #       # #     # #     #   #     # #
# ### ### ####### # # ### ### ### # # ### ######### # ### ##### ####### # ### # ####### ######### #
#   #   # #       # #   # #   #   # #   #   #     # #   # #     #       # #     #       #   #     #
# # ### # # ####### ### ### ####### ### ##### ### # # # ### ########### # ####### ####### # # ### #
# #     #             #             #         #     # #                 #                 #   #   #
###################################################################################################

