###################################################################################################
#   #       #     #           #               #         #   #             #       #             # #
### ### ### # ##### ####### ### ####### ####### ####### # # # ### ######### ### # ##### ####### # #
# #     # # #     #   #   # #         #         #     # # # # # # #           # #     # # #   # # #
# ####### # ##### ### ### # # ######### ######### ### # # # # # # # ########### ##### # # # # # # #
#         # #     # #     # #   #     #   #     # #   # # #   #A#   #   # #   # #       # # # #   #
# ####### # # ### # # ##### # ### ### # ### ### # # ### # ##### ##### # # # # # ######### # # ### #
# #     # # #   #   # #     # #   # # # #   #     #     # #   #       # # # #   #   #   # # #     #
# # ### # # # # # ### # ##### # ### # # # ####### ####### # # # ####### # # ##### # # # # # #######
# # # # # # # # # #   #     # #   # # # #     #   #     #   #   #   # #   #       #   # # #   #   #
### # # # # ### ### ####### # ### # # ### ### # ### ### ### ##### # # ### ############# # ### # ###
#   #     #   #     #     #   #   # #   # #   #   #   #     #     # #   # #   #         #   # #   #
# ########### # ##### # ####### ### ### ### ######### ####### ##### # ### # # # ########### # ### #
# #   #     # #     # # #       #     # #   #         #     #   # # # #   # # #       #     #   # #
# # # # # ### ##### # # # ####### ### # # ### ######### ####### # # # # ### # ####### # # ##### # #
#   #   #     #   # # # #   # #   # #   #   #   #       #     # #   # #   # # #   #   # #         #
# ############# # # ### ### # # ### ##### # ### ##### # # ### # # ### ### # # # ### ### ##### #####
# #       #     # #       # # # # #       #           # # # #   #   # #   # # # #   #   #   # #   #
# ### ### ### ### ##### ### # # # # ####### ########### # # ####### # # ### # # # ### ### # ### # #
#     # #     #   # #   #   #   #   #     # #   #       # #     #   #   #   #   # # #   # #     # #
####### ####### ### # ### ##### ##### ### ### # ######### # # # # ### ##### ##### # ### # ####### #
# #     #     # #   #   #     #       # #     #           # # # # # # #   #     # #     # #       #
# # ### # # # # # # ###o##### # ####### ##################### ### # # # # ### # # ####### # ##### #
# # # #   # # # # #   # #   # # #   #   #         #           #   # #   #   # # #       # #     # #
# # # ##### # # # # ### ### # ### # # # ##### ### # ####### ### ### ####### ### ####### # ##### # #
#   #     # # # # #   #   # #     # # #     #   # #     #   #   #         # #   #     #   #   # # #
# ### # ### # # ### # ### # ####### # ##### ##### ### ### # # ### ### ##### # # # ########### # ###
#   # #   # # #   # #   #       #   # #         #     #   # # #   #   #     # # #         #   #   #
### # ### # ##### # ### ####### # ### ######### ####### ### # # # ##### ##### # ### ### # # # ### #
# # #   # #       # #   #       # #   #       #       # #   # # # #         # #   # #   # # #   # #
# # ##### ########### ### ####### # ### ##### ####### # # ### # ### ####### # ### # # ### # ##### #
# #   #             #     #       #   #     #       #   # #   #     #   #     # # # # #     #     #
# ### # ########### ##### # ####### # ##### ####### ### ### ### ##### # ####### # ### ####### ### #
#     # # #       # #   # # #       #     # #   #   #   #   #       # #       #       #       #   #
# ##### # # # ##### # # ### # ####### ### # ### # ####### ####### ### ####### ######### ####### ###
# #     #   # #   # # #   # #   #   # #   #     #       # #   #   #   #o    # #   # o   #     #   #
# # ##### ### # # # # ### # ### # # # ######### ####### # # # ##### ### ##### # # # ##### # ##### #
#   #       #   #     #     #     # #                 #     #       #           #   #     #       #
###################################################################################################

