###################################################################################################
#   #       #         #     #         #     #   #           #         #   #   #     #     #       #
### # # ##### # ##### # ### ### ##### ##### # # # ####### # ### ##### # # # # # # # # ### ##### # #
#   # #       # #   #   # #     #   #     #   #       #   #     # #   # #   # # # #   #       # # #
# ### ######### # # ##### ####### ####### # ########### ######### # ### ##### # # ########### # # #
#   #   #     #   # #       #     #     # #     #   #   #         #     #     # #       # #   # # #
### ### # ### ##### # # ### # # ### # # # ### ### # # ### ####### ####### ##### ####### # # ### # #
#   #   #   #       # #   # # #     # # # #   #   #   #   #   #         #   # #   #     # # #   # #
# ######### ######### ### # # ####### ### ##### ####### ### # # ### ####### # # ### ##### # # ### #
# #       # #       # #   # #   #   # #   #   #       #     # # #   #     # #   #   #     # #   # #
# # ##### # # ### # ### ####### ### # # ### # ####### ### ##### ##### # ### ##### ##### # # ##### #
# #   # #   # #   #     #     #   # # #     #     #   #   #   #   #   #   #       #     # # #   # #
# ### # ####### ######### # # ### # # ########### # ##### # # ### # ##### ########### ##### # # # #
# #   #         #   #     # # #   # #   #       #   #   # # # #   # # #             #   #   # # # #
# # ### ### # ### # # ##### ### ### # # # ### ####### # ### # # # # # # ########### ### # ### # # #
# # #     # # #   # #     #     #   # # # # #         #     #   # #   #       #   #   # #     #   #
# # # ##### ### ### ##### ####### # # ### # ######### ########### ### ####### ### ### # ######### #
# # # #     #   # #     #         # #   # #         # # #         #   #     #   #       #       # #
# # # # ### # ### ### ############# ### # ### ### ### # # ######### ##### # ### ####### # ##### # #
# # # #   # # #     #       #     # # # #   # #   #   #     #     # #     #   # #     #   # #   # #
# # # ### ### ### # ### ### # ### # # # ### ### ### # ####### ### # ### # ##### # ### ##### # ### #
# # #   #     #   #   #   # #   # #   #   #   # #   # #       # #   #   # #   #     # #   #   # # #
# # ### ####### ##### ### ##### # ### ### ### # # ##### ####### ##### ### # # ####### # ### ### # #
#   #   # #       #     #       #       #   # # # #     # #           #   # #   #     #   # #   # #
##### ### # ##### ########### ########### # # # # # ##### # # ####### ##### ### # ##### # # # ### #
#   # #   # # #   #         # #           # # # # # #     # #     #   #     #     #   # # # # #   #
### # ### # # # # # ####### # # ####### ##### # # # # # ### ##### # ### ##### ##### ### # # # # ###
#   #   # # # # # #   # #   # #   #     #   # # #   # #   # #   # # #   #     #   #     #     # # #
# # ### # # # # ##### # # ##### # # ##### # # # ##### ### # # # # ### ######### # ########### # # #
# # #   #     #   #   # # #   # # # #     #   #     #   # #   # #   # #     #   #         #   # # #
# ### ########### # ### # # # # # ### ######### ### ##### ##### ### # # ### # ########### # ### # #
# #   #       #   # #   #   # # #   #   #       #       #     # # # #   # # #     #   #   #   #   #
# # ### ##### # # # # # ##### ##### ### ##### ######### # ### # # # ##### # ##### # # # ### ##### #
#   #   #   #   # # # # #   # #     # #     #     #   # #   #   # #   #   #   #     # # # # #     #
# ##### # # ##### # # # # # # # ### # ##### ##### ### # ### ##### # # # # # ### ####### # # # #####
# #     # #   #   # # #   #   #   #       #     #   #   # #       # # # # #       #     #   #   # #
# # ##### ##### ### ### ######### ##### ####### ### # ### ##### ### # ### ######### ##### ##### # #
# #     # #     # #   # #   #     #   # #     # #   # #         #   #   #     #     #   # # #   # #
# ##### # # ##### ### # # # # ##### ### # # ### # ### # ##### ### ##### # ### # ##### ### # # ### #
#   #   #   #       # # # # # #         # #   # # #   # #   #   # #     #   # # #     #     # #   #
### # ### ######### # # # # # # ######### ### # # ### ### # ### # # ####### # # ##### # ##### # ###
#     #   #     #   # # # #   # #     # o # #   #   #    o# #   # #         # #     #   #     #   #
####### ##### # # ### # # ##### ##### # ### ####### ####### ##### ########### ##### # ### ####### #
#     #       #   #   # # #   # #     #   #         #       #   # #         #   #   # # # #       #
# ### ### ####### # ### # # # # # ####### # ##### ####### ### # # # ##### # ### # ### # # ##### ###
#   # #   #     # # # #   # #     #     # # #   #       # #   #   # #   # #     # #     #     #   #
# # # ##### ### # # # ##### ####### # ### # # ##### ### # # # ##### # # ### ##### ##### ##### # # #
# # #       # # # # #   #   #   #   # #   #   #   # #   # # # #     # #   # #   #   #   #   # # # #
### ######### # ### # # # ### ### ### # ####### # ### ### # # ####### ### # # # ### # ### # # ### #
#   #       #   #   # #       #   #   # #       #     #   # #       # # # #   # # # #   # # #     #
# ### ##### # ### ### ######### ### ### # ### ##### ##### ####### # # # # ##### # # ### ### ##### #
# #   #     #   # #   #         # #   # # #   #   # #   #       # # #   # # #     # # # #     # # #
# ##### ### ### # ### # ######### ### # # ### # # ### # ####### # # ### # # # ##### # # # ### # # #
#     #   # #   #   # #       #     #   #   # # #     #   #   # # #   # # # # #     # # # #     # #
# ### # # ### ##### # ####### # ### ##### # ### ##### ### ### # # # ### # # # # ##### # # # ##### #
# #   # #   # #     # #       #   # # #   # #   #   #   # #   # # #     # #   # #       # # #   # #
### # ##### # # ### ### ####### # # # # ### # ### # ### # # # # ##### ### # ### ##### ### ### # # #
#   # #   #   #   # #   # #     # #   # # #     # # #   # # # #     # #   #   #     # #   #   # # #
# ##### # ### ### # # ### # ##### ##### # ####### # ##### # # ##### ### ##### ##### # ### # ### # #
#       #   #   # # # #   #   # # #   #   # #   # #       # # #   #     #   #   #   #     # # # # #
# ######### ### # # # # # ### # # # # ### # # # # ######### # # # ####### ##### # ### ##### # # # #
#   #   # # # #   # # # #       # # #   # # # # # #         # # #               #   # #     # #   #
### # # # # # ### ### # ######### # # # # # # # # # ####### ### ################### ### ##### #####
#   # # # # # #   #   # #     #   # # # #   # #   # #     #     #           #     #   # #       # #
# ### # # # # # ### ### # # ### ### # # ### # ##### # ### ####### ##### ### # ### ###A# ##### # # #
#     # # # #   #   #   # #   #   # # # #   #     #   # #       #   #   #   #   # # # #   #   #   #
####### # # ##### ### ### ### ### # # ### ####### ##### # ##### ##### ### ##### # # # ### # ##### #
#   # #   #       #   #   # #   # # #   #   #   #     #   #   #       #       # # # # #   #   #   #
# # # ### ########### # ### ### # # ### ### ### ##### ### # # ############### # # # # # ##### # ###
# #     # # #       # #       # #   # #   #     #   #   # # #       #   #   # # #   #   #     #   #
# ##### # # # # ### # ####### # ##### ### ### ### # ### # # ####### # # # # # # ### ##### #########
#   #   # #   #   # #   #   # #         #   # #   # #   # # #   #   # # # #   # #   #   #     #   #
# # ##### # ##### # ### # # # ######### # ### # ### # # ### # # # ### # ##### # # ### # ##### # # #
# #       # #     # # # # #     #   #   #     # #     # #   # # #     # #   #   # #   #     #   # #
# ########### ##### # # ### ##### # # ######### ######### ### # ####### # # ##### # ####### ##### #
# #   # #     #   # #     #   #   #   #       #   #       #   #       #   # #   # # #       #     #
# # # # # # ##### # ##### ##### ### ### ### # ### # ########### ##### ##### # # # # # ####### ### #
# # # # # # #   #     #       # #   #   # # # # # #   #       #   #   #   # # #   # #       #   # #
# # # # # # # # ##### ####### # # ### ### # # # # ### # ### # ### ##### # # ### ### ####### # # # #
#   # #   #   #   # #     #   # # #   #   # # # #   # #   # #   # #     # #   # #     #   # # # # #
##### ########### # ##### # ### ### ### # # # # ### # # ### ### # # ##### ### # ##### # ### ### # #
#   #             #   #   # #       #   # # # #   # # # #   #   # # #   #     #   #   #   # #   # #
# ################# ### ### ##### ##### # # # ### # # ### ### ### # ### ######### # ##### # # #####
#           #         # #   #   #   #   # # #     # #     #   #   #   #       #     #   # # #     #
# ### ##### ######### # # ### # ### # # ### ##### # ####### ### ##### ##### # # ##### # # # # ### #
# #   #     #         # #     #   #   # #   #     #         #       #     # #   #     # # # # #   #
# # ##### ### ######### ######### ##### # # ##### ######### ##### # ##### ####### ##### # # ### # #
# # #   #     #   #     #             # # # #   #     #   #       #     #           #   # # #   # #
### # # ### ### # # ################# ### ### # ####### # ####### ################### ### # # ### #
#   # #   # #   # # #     #   #     #     #   #         #   #     #   #             # #       #   #
# ### ### # # ### # ### # # # # ### ### ### ############### #######o# # ########### # #############
#     #   # # # # #     #   #   #   # # #   #   #           #       # #   #     #   # #           #
# ##### ### # # # ############### ### # # ### ### ########### ####### ### # ##### ### # ######### #
#   # # #   #   #       #       #   #   # #   #   #     # #   #     #   # #   #   #   #       #   #
### # # ####### ##### ### ### ##### ##### # ### ### # # # # # ##### ### # # # # ##### ####### # # #
# #   #       # #   #   # # #     #       #   # #   # # #   # #     #   # # # # #   #         # # #
# ### ####### # ### ### # # ### ########### # # ##### # ##### # ##### ### # # # # # ########### # #
#           #         #       #             #         #       #           # #     #             # #
###################################################################################################

