###################################################################################################
# #         #     #           #               #         #   #           #   #       #   #     #   #
# ##### ### # # ### ##### ### ### # ######### # ####### # # ####### ### # # ### ### # # ### # # # #
#     #   # # #     #     #     # # #       #   #     #   #   #   # #   # #   #   #   #   # #   # #
##### ### # # ####### ######### ### # ##### ##### ########### # # # # ### ### # # ####### # ##### #
#   # # # #   #     #       #     # #   #     #   #   #     #   #   #     # # # #     #   # #     #
# # # # # ##### # ######### ##### # ##### ##### # # # # ### ############### # # ##### # ##### #####
# # # # #   #   #   #     #     # #     #   #   # # #   #         # #     #   # #     #     #     #
# ### # ### ### ### # ### ##### # ##### # # # ### # ##### # ##### # # # ### ##### ######### ##### #
#   # #       #   #   #       # # #     # # #   # # #   # # #   #   # #   #       # #     #       #
# # # # ##### ### ##### ##### # # # ####### ### # # # # # ### # ##### ### ######### # # # ####### #
# #   # #   # #   #   #     # # #   #         # #   # #   #   #       # #       #     # #     #   #
# ####### # # ##### # # ### ### ####### ##### # ##### ##### ########### # # ##### ##### ####### ###
#     #   # # #     # # #   #   #       #   # #   # #   #   #           # # #     #   #         # #
##### # ### # # ##### ### ### ##### ##### # ##### # ### # ### ######### # ### ##### # ########### #
#   #   #   # #   #   #   #   #     #     #     # #   #   # # # #       #   # # #   #       #     #
# # ##### ### # # # ### ### ### ### # ######### # ### ##### # # # ##### ### # # # ####### # ##### #
# # #   #   # # # # #     #   # #   #     # #   #   #       #   # #       #   # #   #     #       #
# # # # ### # ### # ##### ### # ######### # # ##### ####### ### # ####### ##### # ### ########### #
# # # #   # #   # #       #   #   #   #   # #     # #       #   #   #   #   #   # #   #     #   # #
# # # ### # ### # ####### # ### # # # # ### ##### # # ####### ##### # # ### ### # # ### ### # ### #
# #   #   # #     # #     # #   #   #   # #     #   # #   #   #   #   #   #   # # #       # # #   #
# ##### ### ####### # ##### # ########### # ### ##### # # # ### # ####### ### # # ######### # # ###
#   #     #   # #     #   # # #     # #       #     #   #   #   #       # # #   # #     #   #   # #
### # ####### # # ####### # # ### # # # ####### # # ##### ##### ######### # ### # # ### # ##### # #
#   # # #   # # #         # #     # #   # #   # # #     # #     #   #     #     # # #   #     #   #
# ### # # # # # ######### # ####### # ### # # ### ##### # ### # # # # ##### ##### # # ####### #####
# #   # # #   #   #     # #     #   #     # #     #   # #     # # #   #         # # #   #   #     #
# # ### # ##### # # ### # ##### ### ##### # ####### # # # ##### # ############### # ### # ####### #
# #     # #   # #     #   #   #   # #   # # #       #   # #   # #           #   #   #   # #       #
# ####### # # # ########### # ### # # # # # ##### ######### # # ########### # # ##### ### # ##### #
# #     # # # #     #   #   #     #   # # # #   #   #       # #         # # # #   #   #   # #   # #
# # ### # # # ####### # # ############# ### # # ### # ####### ######### # # # ### # ##### # # # # #
#   # #   # # #       #   #     #       #   # #   #   #     # #   #       #     #     #   #   # # #
# ### ##### # # ########### ### # ####### ### ### ######### # # ### ################# # ####### # #
# #     #   #   #         # # #   #   # #   # # #   #     # # # #   #             # # # #       # #
# ### # # ########### # # # # ##### # # # # # # ### # ### # # # # ### ########### # # # # ####### #
#     # #   #       # # # #   #     #   # #   #   #     # # # #     # #         # #     #   #   # #
####### # # # ##### ### ##### ##### ##### ##### ######### # # ####### ##### # # # ##### ### # ### #
# #     # #   #   #   # #   #     #     #   #   #       # #   #   #   #   # # # # #   # #   # #   #
# # ####### ##### ### # # # ##### ### # ### ### # ##### # # ### # # # # # # # ### # # ### ### # ###
#   #     #       #   #   #     #   # #   # #   # #   # # # #   #   # # # # #       #     #   # # #
# ### ### ######### ### ##### # ### ### # # # ### # ### # # # ######### # # ############### # # # #
# #     #         #   #   # # #   #   # # # # #   #   #   # #     #     # # #           #   #   # #
# ##### ######### # # ### # # # ##### # # # # # ### # ##### # ### # ##### ### ######### # ####### #
#       #       # # #   #   # # #   # # #     #   # # #     #   #       # #   #   # #   # #       #
########### ##### ##### ### # ### # # ######### # ### # ##### ######### # # ### # # # ### ####### #
#           #     #     #   # #   # #   #     # # #   #   #   #   #     # #     #   # # #   #     #
# ### ### ### ##### ##### ### # ### ### # ### ### # # ### # ### # ### ### ####### ### # ### # ### #
# # #   # #   # #   #   # # #   # #   #   # #     # # #   # #   #   #   #       # #   #     #   # #
# # ### ### ### # # # ### # ##### ### ##### ####### ### ##### ##### ##### ### ### # ### ####### # #
#     #     #     # #   # #   #   #             #   #   #     #   #     # #   #   #   #         # #
##### ####### ##### ### # # # ### # ########### # # # ### ####### ##### # ##### ##### ########### #
#   # #     # # #   #   # # #     #           # # # # #   # #     #   # #       #   #   #   #     #
# # # # # # # # # ### ### # ##### ########### # # # # ### # # # # # # # ##### ### ##### # # # #####
# # # # # # #   #   #   #   #           #     #   # # #   #   # #   # #     #     #     # # # #   #
# ### # # # ### ### # # ### ############# ########### # ####### ##### ##### ##### # ##### # # ### #
#     # # # #     # # #     #   #     #   #   #       # #       #   #   #   #     # #     # # #   #
# ##### # # ####### # ####### # # ### # # # # # ####### ### ##### # ##### ### ##### # # ##### # ###
# #   # # #     #   #   # #   # # #   # # # #   #     #   #       #     # #       # # # #   # #   #
# # # ### ##### # ##### # # ### # ### # # # ####### # ### # ########### # ######### ### # # # ### #
#   #     #   #   #   #   # #   #   #   # # #       #     #       #   #   #         #   # #       #
########### ######### ### # ### ### # ##### # ### ### ########### # ##### # ######### ### #########
#           #         #   #   #     # #   # #   #   # #     #   # # #   #   #   #   #     #   #   #
# ##### ##### # ### ### ##### # ####### # # # ##### ### ### # # # # # # ##### # # # # ##### ### # #
#   # #       # #   #   #   # # #       # # # #     #   #   # #     # #     # # # #         #   # #
### # ######### ##### ### # # ### ####### # # # ### # ### ### ##### # ##### # # ######### ### ### #
#   #     #   #   #       # #   #   #   #   # #   # #   #   # #   # #     #   #       #   #   #   #
# ### ### # ##### # ####### ### ### ### ##### ### # ### ### # # # ####### ########### # ### ### ###
# #   #   #     # # #   #   #   # #         # #   #   # # # # # #         #   #       # #   # #   #
# ### # ##### # # # # # ##### # # ######### # # ##### # # # # # ########### # # ######### ### ### #
# #   # #   # # #   # #   #   # #   #   #   # #   #   # # # # # #   #       # # #         #     # #
# # ### # # # # ##### ### # ### # # # # # ### ### ##### # # ### # # # ####### # # ############# # #
#   # #   #   #   #   # # # #   # # # # # #   # #       # #       # # #   #   #   #             # #
##### ########### # ### # # # ### # # # # # ### ######### ########### ### # ### ########### # ### #
#       #   #     # #   #   #     #   # # #   #           #     #   # #   #   # #       #   # #   #
# ### ### # # ##### ### # ######### ##### ### # # ####### # ### # # # # ##### # # ##### # ### # # #
# # #     #       #   #   #     # # #     # # # # #       # # # # #   # #     #   #       #   # # #
# # ############# ### # ### ### # # # ##### # # # # ####### # # # ##### # ##### ########### ### # #
# #         #   # #   # #     # # # #   #   # # # #   # #   # #   # #   # #     #         # #   # #
# # ####### # # ### ### # ##### # # ### # # # ### ### # # ### ##### # # # # ##### ####### # # #####
#   # #     # #     #   # # #   #   # # # # #     #     #   #     #   #   # #   #   #   # # #     #
##### # ##### # ####### # # # ### ### # # # # ########### # # ##### ####### ### ### # ### # ##### #
#     # #   # # #     # # # # #   #   # # #   #         # # # A     #   #         # # #   # #     #
# ### # # # # ### ### ### # # # ### ### # ##### ####### # # # ####### # ########### # # ### # ### #
# # # #   # #       #   #   # # #   #   # #     #       # # #         #   #     #   # # #   # # # #
# # # # ############### ### # # # ### ### # ######### ##### ############# # ### # ### # ##### # # #
# #   # #   #           #   # #   #   # # #         #       #       #   #   #   # # #   #   # #   #
# ##### # # # ######### # ### # ### ### # ######### ######### ##### # # ##### ### # # ### # # # ###
#       # #   #   #     # # # # #   #     # #     #   #         #   # #   # #   # # #     # # # # #
# ####### ##### ### ##### # # ### ####### # # ### # # # ######### ### ### # ### # # ####### # # # #
# #     #   #           #   #     #     #   # #   # # #   #       #     #     #   # #     # # #   #
# # # ##### ### ####### ### ######### # ### # # ##### ### # ####### ### ##### ##### # ### # # #####
# # #     #   # #     #   #     #     #   # # #   #   #   # # #   # # #     # #     #   # # #     #
# ####### ### ### ### ######### # ####### # # ### # ### ### # # # # # ##### ### ### ### # # # ### #
#   #     # #   #   # #         # # #   # # # # # #     #   #   # # #   #   #   # #   # #   #   # #
### # ### # ### ### # # ######### # # # # ### # # ####### ### ### # # # # ### ### ### # ######### #
#     #       #     #             #   #       #           #     #     # #           #            o#
###################################################################################################
