###################################################################################################
# #         # #             #         #     #     #         #   #                         #       #
# ### ##### # # ##### ##### # ####### ### # # ### ### ##### # # # ########### ####### ### # # ### #
#   #   #     #   #   #   #   #   #   #   #   #   #   #   #   # # #     #   #   #     #   # # # # #
### # # ######### # ### ####### ### ### ####### ### ### # ##### ### ### # # ### # ####### ### # # #
#   # #           #   #     #       #   #       #   # # #     #     # #   # #   #o  #   #     # # #
# ################### # ### # ####### # # ######### # # ### ######### ##### # ##### # # ####### # #
#         #   #   #   #   # # #       # # #         # #   #     #         # #     # # # #         #
######### # # # # # ##### # # ######### # ##### ##### ### ### ### #####o# # ##### # # # ######### #
#       #   #   #   # #   #   #       # #       #         # #     #     # #     # #   #         # #
####### ############# # ####### ##### # ######### ######### ####### ##### ##### ############### # #
#         #     #  o#   #     #     #   #     # #           #     # #     #   #       #         # #
# ####### # ### # # # ### # # ##### ##### ### # ######### ### ### # ##### # ######### # ##### #####
#     # #   # #   # #   # # #     #         # #           #   # # #     # # #     #   #     # #   #
# ### # ##### ##### ### # # ##### # ######### # ########### ### # ##### # # # ### # ####### # # # #
# # # #   #     #   #   # #   #   #   # #     #     #     # #   #   #   # # #   #   #     # # # # #
# # # # ### ### # ### ####### ### ### # # ######### # # ### # # ### # ### # ### ####### # # ### # #
#   # #   # #   #   # #     #   # # #   #     #       # #   # #   # # # #     # #       #   #   # #
##### # # # # ##### # # # # ### # # # ####### ### ##### # ##### ### # # ### ### # ### ####### ### #
#     # #   #     # # # # # #   # #   #     #   # #   # #     #   # # #     #   # # #     #   #   #
# ##### ######### # # ### # # ### # ### ### ### ### # # ##### ### # # # ##### ### # ##### # ### ###
# #       #     # # #   # # # # # #   #   #   # #   # #   # #   #     # #     # #       # #   #   #
# ####### ###A# # # ### # # # # # ####### ### # # ### ### # ### ######### ##### ##### ### ### ### #
#     #       # #   #   # #   #   #   #   #   #     # # # #   #           #       #   #     # #   #
# ### ######### ##### ### ##### ### # # ### ####### # # # # # ############### # ### ### ### # # # #
# #   #       # #     #     #   #   #   # #     #   # #   # #   #     #     # #     # #   # # # # #
# # ### ##### ### ######### # ##### ##### ##### ##### # ##### # # ### # # # ####### # ### ### # ###
# # #   # #   #   #         #     #     #     #       #     # #   # #   # #       #     #   # #   #
# # # ### # ### ##### ########### # ### # # ############### # ##### ##### ####### ##### ### # ### #
# # #   # #   # #     #       # # # #   # # #             # # #     #     # #   #   #     #     # #
### ### # ### # # ######### # # # ### ### # # # ######### # # ### ### ##### # # ### ### ######### #
#     # #   #   # #         # # #   # # # #   # #     #   # #     #   #     # #   #   # #         #
# ##### # # ##### ### # ##### # ### # # # ##### # ### ##### # ##### ##### ### # # ### # # ####### #
# #   # # #         # #     #     #   # # #   # #   #     # # #     #     #   # #   # # # #     # #
# # # # # ######### # ##### ##### ##### # # # # ### ##### # ### ##### # ### ### ##### ### ##### # #
# # #   # #       # # #   #     # #     # # # #     #   #   #   #     # #   # #     #   # #     # #
# # ####### ##### # # # # ##### ### ### # # # ####### # ##### ### ### ### ### ##### ### # # ##### #
#           #       #   #     #       #     #         #       #     #             #       #       #
###################################################################################################

